11x11
###########
#*...#....#
#.##.#.##.#
#.#.....#.#
#.#.###.#.#
#.... ....#
#.#.###.#.#
#.#.....#.#
#.##.#.##.#
#....#...*#
###########
5,5,100.0,0.08
2
1,4,1,80.0,0.07,DepthFirst
1,6,2,50.0,0.1,BreadthFirst